ALGEMENE GEGEVENS BORING
NITG-nummer: 	B62B0847
X-coordinaat (m): 	192260
Y-coordinaat (m): 	321800
Coordinatensysteem: 	RD2000
Plaatsnaam: 	Voerendaal
Provincie: 	Limburg
Kaartblad: 	62B
Bepaling locatie: 	Onbekend
Maaiveldhoogte (meter t.o.v. NAP): 	86.80
Bepaling maaiveldhoogte: 	geschat, Top. Kaart 1:25.000
Boormethode: 	Zuigboring
Einddiepte (meter beneden maaiveld): 	78.00
Datum boring: 	01-04-1980
Eigenaar: 	Onbekend
Uitvoerder: 	Smet, de, Dessel (B)

ALGEMENE GEGEVENS LITHOLOGIE
Beschrijver lagen: 	Verreussel, J.M.
Organisatie beschrijver: 	RGD
Beschrijvingsmethode: 	Onbekend
Nat/Droog beschreven: 	Onbekend
Datum laagbeschrijving: 	Onbekend
Kwaliteitcode beschrijving lithologie: 	D


LITHOLOGIE LAGEN											
Bovenkant laag (m beneden maaiveld)	Onderkant laag (m beneden maaiveld)	Kleur	Hoofdgrondsoort	Sublaag	Zandmediaan M63	Zandmediaanklasse	Bijmenging klei	Lutum %	Bijmenging silt	Silt%	Bijmenging zand	Zand %	Bijmenging grind	Grind %	Bijmenging humus	Organische stof %	Kalkgehalte
    0.00	   10.50	onbekend	leem	---	---	---	---	---	---	---	---	---	---	---	---	---	---	
   10.50	   12.00	onbekend	grind	---	---	---	---	---	---	---	---	---	---	---	---	---	---	
   12.00	   45.00	grijs-wit	zand	---	---	fijne categorie (O)	---	---	---	---	---	---	---	---	---	---	---	
   45.00	   78.00	onbekend	mergel	---	---	---	---	---	---	---	---	---	---	---	---	---	---	
