ALGEMENE GEGEVENS BORING
NITG-nummer: 	B62B0709
X-coordinaat (m): 	196196
Y-coordinaat (m): 	318847
Coordinatensysteem: 	RD2000
Plaatsnaam: 	Heerlen
Provincie: 	Limburg
Kaartblad: 	62B
Bepaling locatie: 	Onbekend
Maaiveldhoogte (meter t.o.v. NAP): 	158.01
Bepaling maaiveldhoogte: 	Landmeting
Boormethode: 	Onbekend
Einddiepte (meter beneden maaiveld): 	8.00
Datum boring: 	01-12-1969
Eigenaar: 	Onbekend
Uitvoerder: 	Ruiter, C. de, Halfweg

ALGEMENE GEGEVENS LITHOLOGIE
Beschrijver lagen: 	Onbekend
Organisatie beschrijver: 	Ruiter, C. de; Halfweg
Beschrijvingsmethode: 	Onbekend
Nat/Droog beschreven: 	Onbekend
Datum laagbeschrijving: 	Onbekend
Kwaliteitcode beschrijving lithologie: 	D


LITHOLOGIE LAGEN											
Bovenkant laag (m beneden maaiveld)	Onderkant laag (m beneden maaiveld)	Kleur	Hoofdgrondsoort	Sublaag	Zandmediaan M63	Zandmediaanklasse	Bijmenging klei	Lutum %	Bijmenging silt	Silt%	Bijmenging zand	Zand %	Bijmenging grind	Grind %	Bijmenging humus	Organische stof %	Kalkgehalte
    0.00	    0.40	bruin	leem	---	---	---	---	---	siltig	---	---	---	---	---	---	---	---	
    0.40	    1.20	bruin	kalksteen	---	---	---	---	---	---	---	---	---	---	---	---	---	---	
    1.20	    2.60	geel-grijs	kalksteen	---	---	---	---	---	---	---	---	---	---	---	---	---	---	
    2.60	    3.85	geel-grijs	kalksteen	---	---	---	---	---	siltig	---	---	---	---	---	---	---	---	
    3.85	    8.00	onbekend	kalksteen	---	---	---	---	---	---	---	---	---	---	---	---	---	---	
