ALGEMENE GEGEVENS BORING
NITG-nummer: 	B62B0611
X-coordinaat (m): 	197180
Y-coordinaat (m): 	324260
Coordinatensysteem: 	RD2000
Plaatsnaam: 	Heerlen
Provincie: 	Limburg
Kaartblad: 	62B
Bepaling locatie: 	Onbekend
Maaiveldhoogte (meter t.o.v. NAP): 	93.58
Bepaling maaiveldhoogte: 	Onbekend
Boormethode: 	Onbekend
Einddiepte (meter beneden maaiveld): 	12.00
Datum boring: 	01-05-1963
Eigenaar: 	Onbekend
Uitvoerder: 	Mos, J., Rhoon

ALGEMENE GEGEVENS LITHOLOGIE
Beschrijver lagen: 	Onbekend
Organisatie beschrijver: 	Onbekend
Beschrijvingsmethode: 	Onbekend
Nat/Droog beschreven: 	Onbekend
Datum laagbeschrijving: 	Onbekend
Kwaliteitcode beschrijving lithologie: 	D


LITHOLOGIE LAGEN											
Bovenkant laag (m beneden maaiveld)	Onderkant laag (m beneden maaiveld)	Kleur	Hoofdgrondsoort	Sublaag	Zandmediaan M63	Zandmediaanklasse	Bijmenging klei	Lutum %	Bijmenging silt	Silt%	Bijmenging zand	Zand %	Bijmenging grind	Grind %	Bijmenging humus	Organische stof %	Kalkgehalte
    0.00	    0.30	onbekend	klei	---	---	---	---	---	---	---	---	---	---	---	---	---	---	
    0.30	    1.00	bruin	klei	---	---	fijne categorie (O)	---	---	---	---	zwak zandig	---	sterk grindig	---	---	---	---	
    1.00	    2.50	grijs	zand	---	---	fijne categorie (O)	---	---	---	---	---	---	---	---	---	---	---	
    2.50	    6.50	bruin	zand	---	---	fijne categorie (O)	---	---	---	---	---	---	---	---	---	---	---	
    6.50	   12.00	onbekend	zand	---	---	zeer fijn (O)	---	---	siltig	---	---	---	---	---	---	---	---	
