ALGEMENE GEGEVENS BORING
NITG-nummer: 	B62B0140
X-coordinaat (m): 	192470
Y-coordinaat (m): 	323440
Coordinatensysteem: 	RD2000
Plaatsnaam: 	Klimmen
Provincie: 	Limburg
Kaartblad: 	62B
Bepaling locatie: 	Onbekend
Maaiveldhoogte (meter t.o.v. NAP): 	82.50
Bepaling maaiveldhoogte: 	Onbekend
Boormethode: 	Onbekend
Einddiepte (meter beneden maaiveld): 	12.50
Datum boring: 	01-01-1911
Eigenaar: 	Onbekend
Uitvoerder: 	Even, van, Heerlen

ALGEMENE GEGEVENS LITHOLOGIE
Beschrijver lagen: 	Onbekend
Organisatie beschrijver: 	Boorfirma
Beschrijvingsmethode: 	Onbekend
Nat/Droog beschreven: 	Onbekend
Datum laagbeschrijving: 	Onbekend
Kwaliteitcode beschrijving lithologie: 	C


LITHOLOGIE LAGEN											
Bovenkant laag (m beneden maaiveld)	Onderkant laag (m beneden maaiveld)	Kleur	Hoofdgrondsoort	Sublaag	Zandmediaan M63	Zandmediaanklasse	Bijmenging klei	Lutum %	Bijmenging silt	Silt%	Bijmenging zand	Zand %	Bijmenging grind	Grind %	Bijmenging humus	Organische stof %	Kalkgehalte
    0.00	    3.00	onbekend	leem	---	---	---	---	---	---	---	---	---	---	---	---	---	---	
    3.00	   12.50	grijs	zand	---	---	fijne categorie (O)	sterk kleiig	---	---	---	---	---	---	---	---	---	kalkarm	
