ALGEMENE GEGEVENS BORING
NITG-nummer: 	B62B0615
X-coordinaat (m): 	196320
Y-coordinaat (m): 	321040
Coordinatensysteem: 	RD2000
Plaatsnaam: 	Heerlen
Provincie: 	Limburg
Kaartblad: 	62B
Bepaling locatie: 	Onbekend
Maaiveldhoogte (meter t.o.v. NAP): 	110.60
Bepaling maaiveldhoogte: 	Onbekend
Boormethode: 	Onbekend
Einddiepte (meter beneden maaiveld): 	11.00
Datum boring: 	01-01-1963
Eigenaar: 	RWS
Uitvoerder: 	Gruner, R., Sittard

ALGEMENE GEGEVENS LITHOLOGIE
Beschrijver lagen: 	Onbekend
Organisatie beschrijver: 	RGD - Geol. Bureau
Beschrijvingsmethode: 	Onbekend
Nat/Droog beschreven: 	Onbekend
Datum laagbeschrijving: 	Onbekend
Kwaliteitcode beschrijving lithologie: 	C


LITHOLOGIE LAGEN											
Bovenkant laag (m beneden maaiveld)	Onderkant laag (m beneden maaiveld)	Kleur	Hoofdgrondsoort	Sublaag	Zandmediaan M63	Zandmediaanklasse	Bijmenging klei	Lutum %	Bijmenging silt	Silt%	Bijmenging zand	Zand %	Bijmenging grind	Grind %	Bijmenging humus	Organische stof %	Kalkgehalte
    0.00	    0.35	onbekend	leem	---	---	---	---	---	---	---	---	---	---	---	---	---	---	
    0.35	    3.00	geel-bruin	leem	---	---	---	---	---	---	---	---	---	---	---	---	---	kalkloos	
    3.00	    6.30	licht-geel-bruin	leem	---	---	---	---	---	---	---	---	---	---	---	---	---	kalkarm	
    6.30	    6.80	onbekend	zand	---	120	zeer fijn (O)	---	---	---	---	---	---	---	---	---	---	---	
    6.80	   11.00	licht-geel-bruin	zand	---	120	zeer fijn (O)	---	---	---	---	---	---	---	---	---	---	---	
