ALGEMENE GEGEVENS BORING
NITG-nummer: 	B62B0747
X-coordinaat (m): 	194560
Y-coordinaat (m): 	322620
Coordinatensysteem: 	RD2000
Plaatsnaam: 	Heerlen
Provincie: 	Limburg
Kaartblad: 	62B
Bepaling locatie: 	Onbekend
Maaiveldhoogte (meter t.o.v. NAP): 	92.59
Bepaling maaiveldhoogte: 	Landmeting
Boormethode: 	Onbekend
Einddiepte (meter beneden maaiveld): 	10.00
Datum boring: 	08-02-1970
Eigenaar: 	Onbekend
Uitvoerder: 	Fugro

ALGEMENE GEGEVENS LITHOLOGIE
Beschrijver lagen: 	Onbekend
Organisatie beschrijver: 	Fugro
Beschrijvingsmethode: 	Onbekend
Nat/Droog beschreven: 	Onbekend
Datum laagbeschrijving: 	Onbekend
Kwaliteitcode beschrijving lithologie: 	D


LITHOLOGIE LAGEN											
Bovenkant laag (m beneden maaiveld)	Onderkant laag (m beneden maaiveld)	Kleur	Hoofdgrondsoort	Sublaag	Zandmediaan M63	Zandmediaanklasse	Bijmenging klei	Lutum %	Bijmenging silt	Silt%	Bijmenging zand	Zand %	Bijmenging grind	Grind %	Bijmenging humus	Organische stof %	Kalkgehalte
    0.00	    0.15	onbekend	leem	---	---	---	---	---	---	---	zandig	---	---	---	matig humeus	---	---	
    0.15	    1.00	onbekend	leem	---	---	---	---	---	---	---	zandig	---	---	---	---	---	---	
    1.00	    1.40	onbekend	leem	---	---	---	---	---	---	---	zandig	---	sterk grindig	---	---	---	---	
    1.40	    8.60	onbekend	zand	---	---	matig fijn (O)	---	---	sterk siltig	---	---	---	---	---	---	---	---	
    8.60	   10.00	onbekend	leem	---	---	---	---	---	---	---	zandig	---	---	---	---	---	---	
