ALGEMENE GEGEVENS BORING
NITG-nummer: 	B62B4102
X-coordinaat (m): 	191500
Y-coordinaat (m): 	321530
Coordinatensysteem: 	RD2000
Plaatsnaam: 	Onbekend
Provincie: 	Limburg
Kaartblad: 	62B
Bepaling locatie: 	Onbekend
Maaiveldhoogte (meter t.o.v. NAP): 	93.52
Bepaling maaiveldhoogte: 	Onbekend
Boormethode: 	Onbekend
Einddiepte (meter beneden maaiveld): 	5.00
Datum boring: 	01-05-1941
Eigenaar: 	Onbekend
Uitvoerder: 	Gruner R.

ALGEMENE GEGEVENS LITHOLOGIE
Beschrijver lagen: 	Onbekend
Organisatie beschrijver: 	Onbekend
Beschrijvingsmethode: 	Onbekend
Nat/Droog beschreven: 	Onbekend
Datum laagbeschrijving: 	Onbekend
Kwaliteitcode beschrijving lithologie: 	B


LITHOLOGIE LAGEN											
Bovenkant laag (m beneden maaiveld)	Onderkant laag (m beneden maaiveld)	Kleur	Hoofdgrondsoort	Sublaag	Zandmediaan M63	Zandmediaanklasse	Bijmenging klei	Lutum %	Bijmenging silt	Silt%	Bijmenging zand	Zand %	Bijmenging grind	Grind %	Bijmenging humus	Organische stof %	Kalkgehalte
    0.00	    0.35	donker-bruin-grijs	leem	---	---	fijne categorie (O)	---	---	---	---	---	---	---	---	---	---	---	
    0.35	    2.20	licht-bruin-grijs	leem	---	---	---	---	---	---	---	---	---	---	---	---	---	---	
    2.20	    3.40	licht-bruin-grijs	leem	---	---	fijne categorie (O)	---	---	---	---	---	---	---	---	---	---	---	
    3.40	    4.50	bruin-grijs	leem	---	---	fijne categorie (O)	---	---	---	---	---	---	---	---	---	---	---	
    4.50	    5.00	donker-bruin-grijs	leem	---	---	fijne categorie (O)	---	---	---	---	---	---	---	---	---	---	---	
