ALGEMENE GEGEVENS BORING
NITG-nummer: 	B62B3913
X-coordinaat (m): 	196680
Y-coordinaat (m): 	321300
Coordinatensysteem: 	RD2000
Plaatsnaam: 	Heerlen Jaegerstraat
Provincie: 	Limburg
Kaartblad: 	62B
Bepaling locatie: 	Onbekend
Maaiveldhoogte (meter t.o.v. NAP): 	114.45
Bepaling maaiveldhoogte: 	Onbekend
Boormethode: 	Onbekend
Einddiepte (meter beneden maaiveld): 	5.06
Datum boring: 	01-01-1949
Eigenaar: 	Geologisch Bureau
Uitvoerder: 	RGD

ALGEMENE GEGEVENS LITHOLOGIE
Beschrijver lagen: 	Onbekend
Organisatie beschrijver: 	Onbekend
Beschrijvingsmethode: 	Onbekend
Nat/Droog beschreven: 	Onbekend
Datum laagbeschrijving: 	Onbekend
Kwaliteitcode beschrijving lithologie: 	D


LITHOLOGIE LAGEN											
Bovenkant laag (m beneden maaiveld)	Onderkant laag (m beneden maaiveld)	Kleur	Hoofdgrondsoort	Sublaag	Zandmediaan M63	Zandmediaanklasse	Bijmenging klei	Lutum %	Bijmenging silt	Silt%	Bijmenging zand	Zand %	Bijmenging grind	Grind %	Bijmenging humus	Organische stof %	Kalkgehalte
    0.00	    0.40	---	niet benoemd	---	---	---	---	---	---	---	---	---	---	---	---	---	---	
    0.40	    1.46	---	leem	---	---	---	---	---	---	---	sterk zandig	---	---	---	---	---	---	
    1.46	    3.46	---	leem	---	---	---	---	---	---	---	sterk zandig	---	---	---	---	---	---	
    3.46	    4.76	---	leem	---	---	---	---	---	---	---	sterk zandig	---	---	---	---	---	kalkhoudend	
    4.76	    5.06	---	grind	---	---	---	---	---	---	---	---	---	---	---	---	---	---	
