ALGEMENE GEGEVENS BORING
NITG-nummer: 	B62B0323
X-coordinaat (m): 	193580
Y-coordinaat (m): 	321790
Coordinatensysteem: 	RD2000
Plaatsnaam: 	Voerendaal
Provincie: 	Limburg
Kaartblad: 	62B
Bepaling locatie: 	Onbekend
Maaiveldhoogte (meter t.o.v. NAP): 	86.82
Bepaling maaiveldhoogte: 	Landmeting
Boormethode: 	Onbekend
Einddiepte (meter beneden maaiveld): 	31.50
Datum boring: 	01-01-1922
Eigenaar: 	Onbekend
Uitvoerder: 	Hennings, E., Berg aan de Maas

ALGEMENE GEGEVENS LITHOLOGIE
Beschrijver lagen: 	Onbekend
Organisatie beschrijver: 	Onbekend
Beschrijvingsmethode: 	Onbekend
Nat/Droog beschreven: 	Onbekend
Datum laagbeschrijving: 	Onbekend
Kwaliteitcode beschrijving lithologie: 	C


LITHOLOGIE LAGEN											
Bovenkant laag (m beneden maaiveld)	Onderkant laag (m beneden maaiveld)	Kleur	Hoofdgrondsoort	Sublaag	Zandmediaan M63	Zandmediaanklasse	Bijmenging klei	Lutum %	Bijmenging silt	Silt%	Bijmenging zand	Zand %	Bijmenging grind	Grind %	Bijmenging humus	Organische stof %	Kalkgehalte
    0.00	    0.60	onbekend	niet benoemd	---	---	---	---	---	---	---	---	---	---	---	---	---	---	
    0.60	    3.50	grijs	zand	---	---	fijne categorie (O)	kleiig 	---	---	---	---	---	zwak grindig	---	---	---	---	
    3.50	   16.00	grijs-blauw	klei	---	---	---	---	---	---	---	---	---	---	---	---	---	---	
   16.00	   17.80	onbekend	kalksteen	---	---	---	---	---	---	---	---	---	---	---	---	---	---	
   17.80	   31.50	onbekend	kalksteen	---	---	---	---	---	---	---	---	---	---	---	---	---	---	
