ALGEMENE GEGEVENS BORING
NITG-nummer: 	B62B0649
X-coordinaat (m): 	196915
Y-coordinaat (m): 	321800
Coordinatensysteem: 	RD2000
Plaatsnaam: 	Heerlen
Provincie: 	Limburg
Kaartblad: 	62B
Bepaling locatie: 	Onbekend
Maaiveldhoogte (meter t.o.v. NAP): 	117.00
Bepaling maaiveldhoogte: 	Onbekend
Boormethode: 	Onbekend
Einddiepte (meter beneden maaiveld): 	11.30
Datum boring: 	29-01-1968
Eigenaar: 	Onbekend
Uitvoerder: 	Vries, Gebr. de, Ittervoort

ALGEMENE GEGEVENS LITHOLOGIE
Beschrijver lagen: 	Onbekend
Organisatie beschrijver: 	RGD
Beschrijvingsmethode: 	Onbekend
Nat/Droog beschreven: 	Onbekend
Datum laagbeschrijving: 	Onbekend
Kwaliteitcode beschrijving lithologie: 	D


LITHOLOGIE LAGEN											
Bovenkant laag (m beneden maaiveld)	Onderkant laag (m beneden maaiveld)	Kleur	Hoofdgrondsoort	Sublaag	Zandmediaan M63	Zandmediaanklasse	Bijmenging klei	Lutum %	Bijmenging silt	Silt%	Bijmenging zand	Zand %	Bijmenging grind	Grind %	Bijmenging humus	Organische stof %	Kalkgehalte
    0.00	    3.50	bruin	leem	---	---	---	---	---	siltig	---	---	---	---	---	---	---	---	
    3.50	    5.00	bruin-geel	leem	---	---	---	---	---	---	---	---	---	---	---	---	---	kalkarm	
    5.00	    8.50	bruin	leem	---	---	---	---	---	siltig	---	---	---	---	---	---	---	---	
    8.50	   10.00	grijs	grind	---	---	---	---	---	---	---	---	---	---	---	---	---	---	
   10.00	   11.30	grijs	zand	---	---	zeer fijn (O)	kleiig 	---	---	---	---	---	---	---	---	---	---	
