ALGEMENE GEGEVENS BORING
NITG-nummer: 	B62B0907
X-coordinaat (m): 	190960
Y-coordinaat (m): 	320420
Coordinatensysteem: 	RD2000
Plaatsnaam: 	Voerendaal
Provincie: 	Limburg
Kaartblad: 	62B
Bepaling locatie: 	Geschat, Top. Kaart 1:10.000
Maaiveldhoogte (meter t.o.v. NAP): 	117.44
Bepaling maaiveldhoogte: 	Landmeting
Boormethode: 	Spoelboring, Avegaarboring
Einddiepte (meter beneden maaiveld): 	104.00
Datum boring: 	01-06-1992
Eigenaar: 	WML
Uitvoerder: 	Gruner, R., Sittard

ALGEMENE GEGEVENS LITHOLOGIE
Beschrijver lagen: 	Onbekend
Organisatie beschrijver: 	Boorfirma
Beschrijvingsmethode: 	Onbekend
Nat/Droog beschreven: 	Onbekend
Datum laagbeschrijving: 	Onbekend
Kwaliteitcode beschrijving lithologie: 	E


LITHOLOGIE LAGEN											
Bovenkant laag (m beneden maaiveld)	Onderkant laag (m beneden maaiveld)	Kleur	Hoofdgrondsoort	Sublaag	Zandmediaan M63	Zandmediaanklasse	Bijmenging klei	Lutum %	Bijmenging silt	Silt%	Bijmenging zand	Zand %	Bijmenging grind	Grind %	Bijmenging humus	Organische stof %	Kalkgehalte
    0.00	    3.00	onbekend	niet benoemd	---	---	---	---	---	---	---	---	---	---	---	---	---	---	
    3.00	    5.50	onbekend	leem	---	---	---	---	---	---	---	---	---	---	---	---	---	---	
    5.50	   45.50	licht-geel	kalksteen	---	---	---	---	---	---	---	---	---	---	---	---	---	---	
   45.50	   74.00	donker-geel	kalksteen	---	---	---	---	---	---	---	---	---	---	---	---	---	---	
   74.00	  104.00	onbekend	zand	---	---	---	---	---	---	---	---	---	---	---	---	---	---	
