ALGEMENE GEGEVENS BORING
NITG-nummer: 	B62B4247
X-coordinaat (m): 	195795
Y-coordinaat (m): 	319010
Coordinatensysteem: 	RD2000
Plaatsnaam: 	"hoeve ""De Dael"""
Provincie: 	Limburg
Kaartblad: 	62B
Bepaling locatie: 	Onbekend
Maaiveldhoogte (meter t.o.v. NAP): 	130.00
Bepaling maaiveldhoogte: 	Onbekend
Boormethode: 	Onbekend
Einddiepte (meter beneden maaiveld): 	9.00
Datum boring: 	16-02-1973
Eigenaar: 	Rijks Geologische Dienst
Uitvoerder: 	RGD

ALGEMENE GEGEVENS LITHOLOGIE
Beschrijver lagen: 	Onbekend
Organisatie beschrijver: 	Onbekend
Beschrijvingsmethode: 	Onbekend
Nat/Droog beschreven: 	Onbekend
Datum laagbeschrijving: 	Onbekend
Kwaliteitcode beschrijving lithologie: 	D


LITHOLOGIE LAGEN											
Bovenkant laag (m beneden maaiveld)	Onderkant laag (m beneden maaiveld)	Kleur	Hoofdgrondsoort	Sublaag	Zandmediaan M63	Zandmediaanklasse	Bijmenging klei	Lutum %	Bijmenging silt	Silt%	Bijmenging zand	Zand %	Bijmenging grind	Grind %	Bijmenging humus	Organische stof %	Kalkgehalte
    0.00	    0.30	---	zand	---	---	---	---	---	---	---	---	---	---	---	---	---	---	
    0.30	    2.50	bruin	leem	---	---	---	---	---	---	---	sterk zandig	---	---	---	---	---	---	
    2.50	    4.00	geel-bruin	leem	---	---	---	---	---	---	---	sterk zandig	---	---	---	---	---	---	
    4.00	    6.00	bruin	grind	---	---	---	---	---	siltig	---	---	---	---	---	---	---	---	
    6.00	    9.00	groen-grijs	zand	---	---	---	---	---	---	---	---	---	grindig	---	---	---	kalkrijk	
