ALGEMENE GEGEVENS BORING
NITG-nummer: 	B62B0175
X-coordinaat (m): 	196620
Y-coordinaat (m): 	323200
Coordinatensysteem: 	RD2000
Plaatsnaam: 	Heerlen
Provincie: 	Limburg
Kaartblad: 	62B
Bepaling locatie: 	Onbekend
Maaiveldhoogte (meter t.o.v. NAP): 	105.00
Bepaling maaiveldhoogte: 	Onbekend
Boormethode: 	Onbekend
Einddiepte (meter beneden maaiveld): 	11.65
Datum boring: 	01-01-1916
Eigenaar: 	Onbekend
Uitvoerder: 	Rijksopsporing van Delfstoffen

ALGEMENE GEGEVENS LITHOLOGIE
Beschrijver lagen: 	Onbekend
Organisatie beschrijver: 	RGD
Beschrijvingsmethode: 	Onbekend
Nat/Droog beschreven: 	Onbekend
Datum laagbeschrijving: 	Onbekend
Kwaliteitcode beschrijving lithologie: 	C


LITHOLOGIE LAGEN											
Bovenkant laag (m beneden maaiveld)	Onderkant laag (m beneden maaiveld)	Kleur	Hoofdgrondsoort	Sublaag	Zandmediaan M63	Zandmediaanklasse	Bijmenging klei	Lutum %	Bijmenging silt	Silt%	Bijmenging zand	Zand %	Bijmenging grind	Grind %	Bijmenging humus	Organische stof %	Kalkgehalte
    0.00	    3.00	onbekend	leem	---	---	---	---	---	---	---	---	---	---	---	---	---	kalkloos	
    3.00	    3.50	onbekend	leem	---	---	---	---	---	---	---	---	---	---	---	---	---	kalkarm	
    3.50	   10.00	onbekend	leem	---	---	---	---	---	---	---	---	---	---	---	---	---	kalkarm	
   10.00	   10.50	grijs-geel	klei	---	---	---	---	---	---	---	---	---	---	---	---	---	kalkarm	
   10.50	   11.65	donker-grijs	zand	---	---	---	kleiig 	---	---	---	---	---	grindig	---	---	---	---	
