ALGEMENE GEGEVENS BORING
NITG-nummer: 	B62B0276
X-coordinaat (m): 	196210
Y-coordinaat (m): 	322650
Coordinatensysteem: 	RD2000
Plaatsnaam: 	Heerlen
Provincie: 	Limburg
Kaartblad: 	62B
Bepaling locatie: 	Onbekend
Maaiveldhoogte (meter t.o.v. NAP): 	108.00
Bepaling maaiveldhoogte: 	geschat, Hoogtekaart 1:10.000
Boormethode: 	Onbekend
Einddiepte (meter beneden maaiveld): 	10.00
Datum boring: 	01-01-1948
Eigenaar: 	Oranje Nassau Mijnen
Uitvoerder: 	Gruner, R., Sittard

ALGEMENE GEGEVENS LITHOLOGIE
Beschrijver lagen: 	Onbekend
Organisatie beschrijver: 	Onbekend
Beschrijvingsmethode: 	Onbekend
Nat/Droog beschreven: 	Onbekend
Datum laagbeschrijving: 	Onbekend
Kwaliteitcode beschrijving lithologie: 	C


LITHOLOGIE LAGEN											
Bovenkant laag (m beneden maaiveld)	Onderkant laag (m beneden maaiveld)	Kleur	Hoofdgrondsoort	Sublaag	Zandmediaan M63	Zandmediaanklasse	Bijmenging klei	Lutum %	Bijmenging silt	Silt%	Bijmenging zand	Zand %	Bijmenging grind	Grind %	Bijmenging humus	Organische stof %	Kalkgehalte
    0.00	    4.00	bruin	leem	---	---	---	---	---	---	---	---	---	---	---	---	---	kalkloos	
    4.00	    5.50	geel-bruin	leem	---	---	---	---	---	---	---	---	---	---	---	---	---	kalkloos	
    5.50	    7.50	geel-bruin	leem	---	---	---	---	---	---	---	---	---	---	---	---	---	kalkloos	
    7.50	    9.00	geel-bruin	leem	---	---	---	---	---	---	---	---	---	---	---	---	---	kalkloos	
    9.00	   10.00	onbekend	grind	---	---	---	---	---	---	---	---	---	---	---	---	---	---	
