ALGEMENE GEGEVENS BORING
NITG-nummer: 	B62B2537
X-coordinaat (m): 	191424
Y-coordinaat (m): 	319107
Coordinatensysteem: 	RD2000
Plaatsnaam: 	Onbekend
Provincie: 	Limburg
Kaartblad: 	62B
Bepaling locatie: 	Onbekend
Maaiveldhoogte (meter t.o.v. NAP): 	137.50
Bepaling maaiveldhoogte: 	Onbekend
Boormethode: 	Onbekend
Einddiepte (meter beneden maaiveld): 	4.40
Datum boring: 	27-08-1963
Eigenaar: 	Onbekend
Uitvoerder: 	Onbekend

ALGEMENE GEGEVENS LITHOLOGIE
Beschrijver lagen: 	Onbekend
Organisatie beschrijver: 	Onbekend
Beschrijvingsmethode: 	Onbekend
Nat/Droog beschreven: 	Onbekend
Datum laagbeschrijving: 	Onbekend
Kwaliteitcode beschrijving lithologie: 	D


LITHOLOGIE LAGEN											
Bovenkant laag (m beneden maaiveld)	Onderkant laag (m beneden maaiveld)	Kleur	Hoofdgrondsoort	Sublaag	Zandmediaan M63	Zandmediaanklasse	Bijmenging klei	Lutum %	Bijmenging silt	Silt%	Bijmenging zand	Zand %	Bijmenging grind	Grind %	Bijmenging humus	Organische stof %	Kalkgehalte
    0.00	    0.30	onbekend	leem	---	---	---	---	---	---	---	---	---	---	---	---	---	---	
    0.30	    1.00	bruin-geel	leem	---	---	---	---	---	zwak siltig	---	---	---	---	---	---	---	---	
    1.00	    3.40	geel-bruin	leem	---	---	---	---	---	zwak siltig	---	---	---	---	---	---	---	---	
    3.40	    4.30	bruin-geel	leem	---	---	---	---	---	zwak siltig	---	---	---	---	---	---	---	---	
    4.30	    4.40	onbekend	grind	---	---	---	---	---	---	---	---	---	---	---	---	---	---	
