ALGEMENE GEGEVENS BORING
NITG-nummer: 	B62B0051
X-coordinaat (m): 	195750
Y-coordinaat (m): 	324275
Coordinatensysteem: 	RD2000
Plaatsnaam: 	Heerlen
Provincie: 	Limburg
Kaartblad: 	62B
Bepaling locatie: 	Onbekend
Maaiveldhoogte (meter t.o.v. NAP): 	106.00
Bepaling maaiveldhoogte: 	Onbekend
Boormethode: 	Onbekend
Einddiepte (meter beneden maaiveld): 	22.00
Datum boring: 	01-01-1908
Eigenaar: 	Onbekend
Uitvoerder: 	Berg, H. van den, Heusden

ALGEMENE GEGEVENS LITHOLOGIE
Beschrijver lagen: 	Onbekend
Organisatie beschrijver: 	Boorfirma
Beschrijvingsmethode: 	Onbekend
Nat/Droog beschreven: 	Onbekend
Datum laagbeschrijving: 	Onbekend
Kwaliteitcode beschrijving lithologie: 	D


LITHOLOGIE LAGEN											
Bovenkant laag (m beneden maaiveld)	Onderkant laag (m beneden maaiveld)	Kleur	Hoofdgrondsoort	Sublaag	Zandmediaan M63	Zandmediaanklasse	Bijmenging klei	Lutum %	Bijmenging silt	Silt%	Bijmenging zand	Zand %	Bijmenging grind	Grind %	Bijmenging humus	Organische stof %	Kalkgehalte
    0.00	    2.00	grijs	klei	---	---	---	---	---	---	---	sterk zandig	---	---	---	---	---	---	
    2.00	    3.00	onbekend	zand	---	---	---	kleiig 	---	---	---	---	---	---	---	---	---	---	
    3.00	    4.00	donker-groen	zand	---	---	---	kleiig 	---	---	---	---	---	---	---	---	---	---	
    4.00	   10.00	donker-groen	zand	---	---	---	kleiig 	---	---	---	---	---	---	---	---	---	---	
   10.00	   22.00	donker-groen	zand	---	---	---	sterk kleiig	---	---	---	---	---	---	---	---	---	---	
